fast - (almost)

abfahren - abgefahren (leave)
abholen - abgeholt (pick up)
anfangen - angefangen   (to begin)
ankommen - angekommen (arrive)
anrufen - angerufen (call)
arbeiten - gearbeitet
aufhängen - aufgehängt (to hang) 
auspacken -ausgepackt (to unpack)
austehen - ausgestanden (to get up)
beginnen - begonnen 
bekommen - bekommen (receive, also 'catch a disease')
bestellen - bestellt (order)
besuchen - besucht (visit)
bezahlen - bezahlt (pay) 
einkaufen - eingekauft (to do the shopping)
einpacken - eingepackt (to pack)
einschlafen - eingeschlafen (to fall asleep)
erklären - erklärt (explain)
fahren - gefahren (go/drive)
gehen - gegangen (go)
kochen - gekocht
leihen - geliehen (lend)
mitkommen - mitgekommen
steigen - gestiegen (rise, climb)
trinken - getronken
vergessen - vergessen (forget)
verloren - verloren (lost)
verstehen - verstanden

zurückfahren - zurückgefahren (to go back)

ich habe dein Herz gefangen.
